11111111111111111111111111111111111111111111111111111111111111111111111111111111111111111111111111
1C00X0000X111C000000000000000100000000100000000000000100000000000000000000000000000000000110000XC1
1XX0X0X00X001110X01111111111011111001010000000000000010XXXXXXXXXXXXXX11001111110111111000000000001
100000X00X000011100011111111011111X0101000000000000000000000000000000011001111101111100110010010X1
1XXXXXXX0X000000111000111111011E11001010001111110000010000000000000000011001X11011X100110010001001
1XXXXXXX0X00000000111000111101X0000X10100000000100000100000000000000000011001110111001100110111001
1000000000011000000011100011P111111110100000000100000100001111111111110001100110110011001000001001
10001C000000000000000011100001000000001000000000000001000010C000000001000011001C100110011111101001
100011000X000000000000001110010000000010000000010000X1CX001000000000010000C11001001100100000001001
100000000X0000000010000000100100111111111111110111111111111000000000011111111100011001101111111X01
10000001111000000010000000000C00X000000000000X0X00000000000000000000000000000000110010000C00001001
100000000X00000000000000000000000000X0X00000000000X00000000000000000000000000001100111111111101001
100000000X0001000000000000000101111110101111111111111111111111111111111111100011001000000000001001
100000000X0000000000000000000100111100100000000000000000000000000000000000100010011011111111111001
10000000010000000000000010000100011000100000000000100110010000000000000000100010010000000000000001
100000000X00000000010000000001XX0000XX10000000000000000001XX0XX0XX00000000100010011111111111111001
10X000000X00000000010000000001X001100X1000000000000000000100X00X00X000000000001C000000000000000001
1XXX11XXXX0000011000000000000100111100111111111001111111111111111110011111111111111110000000000XX1
1C0000000000000000000000000001C1111110000000000000000000000000000000000000000000000000000000000XX1
11111111111111111111111111111111111111111111111111111111111111111111111111111111111111111111111111