11111111111111111111111111111111111111111111111111111111111111111111111111111111111111111111111111
10000000000000000000000000000100000000100000000000000000000000000000000000000000000000000000000001
10000000000000000000000000000111110010100000000000000000000000000000000000000000000000000000000001
10000000000000000000000000000111110010100000000000000000000000000000000000000000000000000000000001
10000000000000000000000000000111110010100000000000000000000000000000000000000000000000000000000001
100000000000000000000000000001E0000010100000000000000000000000000000000000000000000000000000000001
1000000000000000000000000000P111111110100000000000000000000000000000000000000000000000000000000001
10000000000000000000000000000100000000100000000000000000000000000000000000000000000000000000000001
10000000000000000000000000000100000000100000000000000000000000000000000000000000000000000000000001
10000000000000000000000000000100111111100000000000000000000000000000000000000000000000000000000001
10000000000000000000000000000C00000000000000000000000000000000000000000000000000000000000000000001
10000000000000000000000000000000000000000000000000000000000000000000000000000000000000000000000001
10000000000000000000000000000100000000000000000000000000000000000000000000000000000000000000000001
10000000000000000000000000000100000000000000000000000000000000000000000000000000000000000000000001
10000000000000000000000000000100000000000000000000000000000000000000000000000000000000000000000001
10000000000000000000000000000100000000000000000000000000000000000000000000000000000000000000000001
10000000000000000000000000000100000000000000000000000000000000000000000000000000000000000000000001
10000000000000000000000000000100000000000000000000000000000000000000000000000000000000000000000001
10000000000000000000000000000100000000000000000000000000000000000000000000000000000000000000000001
11111111111111111111111111111111111111111111111111111111111111111111111111111111111111111111111111