11111111
1P0001C1
100001E1
1C000001
11111111