11111111111111111111111111111111111111111111111111111111111111
1PE110011001111100111111011000011011011111100111111011000011C1
100110011011000CC01100110111001110CC001100CC011000001100001101
10011111101100011011111001111111101100110011011110000110011001
1001100110CC00011011001101101101101100CC00110CC000000011110001
100CC00CC001111100CC00CC0CC0000CC0110111111001111110000CC00001
11111111111111111111111111111111111111111111111111111111111111