11111111111111111111111111111111111
1P1C0000000000000001000C100000000C1
10111011101110111000001110111010101
101E1010101000111001001010110010101
10101011101000101001101110111001001
1C0000000000000000000000000000000C1
11111111111111111111111111111111111